11111111
10000001
10P00001
100000E1
11111111