11111111
10000C01
100000C1
1P0000E1
11111111