11111111
10000001
10000C01
1C0P00E1
11111111