11111111
10000001
10P00C01
100000E1
11111111