11111111111111111111
1P00000C000000C000E1
11111111111111111111