111111111111111111
1P00000000000000E1
101011111111111101
1C0000000000000001
111111111111111111