1111111
1P000E1
1C1C1C1
1000001
1111111