1111111111111
1C000000000E1
1001111011101
1P0000C000001
1111011111101
1C00000000001
1111111111111