111111111111111
1P0000000000001
101111111111101
1C00000100000C1
100011101011101
1C00010000000E1
111111111111111